V
20
230
2
4
12
MMMMMMMMMMMMMMMMMMMMMMMMMMMMMMMMMMMMMMMMMMMMMMMMMMMMMMMMMMMM
Mooeeeeeeee oooooooeoooooeeeeeeoeooo ooooo   ooooo oo  ooo M
Mooo eooooooo oooeoeo ooeeoooeooeeeeeooeeoo oeoooo   o ooooM
Mooooee oo oeeo oooeeeeooeeeooeo oeooooo e eoooooeeoooo oooM
Mooeoeeeoeooeooeooeoo oo oooooee ooooeooo  oo eoo ooo oo ooM
Mooo oooeoooooooo oooooeoo oooeeooo oooooooooo ooooooooeo  M
Moooooooooo oooooooooooooooo ooeooooooo oooooooooo ooooooooM
Mkkkk kkkkk kkkkk kkk   kkkk kkkk kkk kk  kkk kkk kkk kkk kM
M             v                                            M
M                                                 MMMMMM   M
M                                                 M   vM   M
M                                                 M MM M   M
M                                       v         . LM M   M
M                    v.          v                M MM M   M
M                     .         .....             Mv   M   M
M                                  v              MMMMMM   M
M              i                                           M
M                                                          M
M                                                          M
M                                                          M
M                                                          M
MMMMMMMMMMMMMMMMMMMMMMMMMMMMMMMMMMMMMMMMMMMMMMMMMMMMMMMMMMMM
eof
 