 BBB  BBB   BBB BBB                       BBBBBBBBBBBBBBBBBBBBBBBBBBBBB
BB  B BB B BB   BB B                      BBBBBBBBBBBBBBBBBBBBBBBBBBBBB
BBBBB BBB  BB   BB B   B                  BBBBBBBBBBBBBBBBBBBBBBBBBBBBB
BBBBB BB B BBBB BBBB         BB     B     BBBBBBBBBBBBBBBBBBBBBBBBBBBBB
BB  B BBBB  BBB BBB   BBBB    B    BBBBBBBBBBBBBBBBBBBBBBBBBBBBBBBBBBBB
                      B       B        BBBBBBBBBBBBBBBBBBBBBBBBBBBBBBBB
BBBBB BBB             B   B   BB        BBBBBBBBBBBBBBBBBBBBBBBBBBBBBBB
BBBBBBBBB   BBBBB     B       BBB        BBBBBBBBBBBBBBBBBBBBBBBBBBBBBB
BBBBBBBBBBBBBBBBBBB  BBBB   BBBBBBBB     BBBBBBBBBBBBBBBBBBBBBBBBBBBBBB
BBBBBBBBBBBB    BBB  B  B  BB            B   B BBBBBBBBBBBBBBBBBBBBBBBB
BBBBBBBBBBB  B       B  B   B           BB       BBBBBBBBBBBBBBBBBBBBBB
BBBBBBBBBB  BB       B BBB  B          BB        BBBBBBBBBBBBBBBBBBBBBB
BBBBBBBBB  BBB       B  B   B       BBBB        BBBBBBBBBBBBBBBBBBBBBBB
BBBBBBBBB BBBBB   BBBBB B  BB      BBBB       B  BBBBBBBBBBBBBBBBBBBBBB
BBBBBBBBB  BBB          B   B       BBB       B  BBBBBBBBBBBBBBBBBBBBBB
BBBBBBBBBB           BBBBB  BB      BB        BB BBBBBBBBBBBBBBBBBBBBBB
       BBBBBBB      BB      BB     BB     BB     BBBBBBBBBBBBBBBBBBBBBB
        BBBBBBB            BBB   BBB       BB   BBBBBBBBBBBBBBBBBBBBBBB
           BBBBBBBBBBBBBBBBBBB        BB   B     BBBBBBBBBBBBBBBBBBBBBB
BB            BBBBBBBBBBBBBBBB             B  B  BBBBBBBBBBBBBBBBBBBBBB
BB            BB BB BBBBBBBBBB            BB     BBBBBBBBBBBBBBBBBBBBBB
BB            BB B    BBBBBBBB        BB   BB   BBBBBBBBBBBBBBBBBBBBBBB
BB            B       B BBBBBB    BB       B     BBBBBBBBBBBBBBBBBBBBBB
BB                       BBBBBBB           B  B  BBBBBBBBBBBBBBBBBBBBBB
BB                         BBB             B     BBBBBBBBBBBBBBBBBBBBBB
BBB                         BB   BB        B    BBBBBBBBBBBBBBBBBBBBBBB
BBBB                         B             B    BBBBBBBBBBBBBBBBBBBBBBB
BBBBBBBBBBBBBBBBBBBBBBBB     B      BBBBB  B   BBBBBBBBBBBBBBBBBBBBBBBB
BBBBBBBBBBBBBBBBBBBBBBB   B  B       BBBBB    BBBBBBBBBBBBBBBBBBBBBBBBB
BBBBBBBBBBBBBBBBBBBBBBB      B    B  BBBBB    BBBBBBBBBBBBBBBBBBBBBBBBB
BBB BBBB BBBBBBB BBBBBB     BB       BBBBBBBBBBBBBBBBBBBBBBBBBBBBBBBBBB
BBB  BB     B    BBBBBB   BBBB      BBBBBBBBBBBBBBBBBBBBBBBBBBBBBBBBBBB
B     B          BBBBBB  BBB B    B  BBBBBBBBBBBBBBBBBBBBBBBBBBBBBBBBBB
                 BBBBBB      B       BBBBBBBBBBBBBBBBBBBBBBBBBBBBBBBBBB
                 BBBBBBBBB          BBBBBBBBBBBBBBBBBBBBBBBBBBBBBBBBBBB
                 BBBBBBBBBBB       BBBBBBBBBBBBBBBBBBBBBBBBBBBBBBBBBBBB
                 BBBBBBBBBBBBBBBBBBBBBBBBBBBBBBBBBBBBBBBBBBBBBBBBBBBBBB
                 BBBBBBBBBBBBBBBBBBBBBBBBBBBBBBBBBBBBBBBBBBBBBBBBBBBBBB
                 BBBBBBBBBBBBBBBBBBBBBBBBBBBBBBBBBBBBBBBBBBBBBBBBBBBBBB